;;;;;;;;;;;;;;;;;;;;;;;###;;;;;###;;;###;;;;;###;;;###;;;;;###;;;;;;;;;;;;;;;;;;;;;;;
;;;;;;;;;;;;;;;;;;;;;;;###########;;;###########;;;###########;;;;;;;;;;;;;;;;;;;;;;;
;;;;;;;;;;;;;;;;;;;;;;;##       ##;;;##       ##;;;##       ##;;;;;;;;;;;;;;;;;;;;;;;
;;;;;;;;;;;;;;;;;;;;;;;;# ##### #;;;;;#       #;;;;;# ##### #;;;;;;;;;;;;;;;;;;;;;;;;
;;;;;;;;;;;;;;;;;;;;;;;;# #ZZZ# #######       ####### #WWW# #;;;;;;;;;;;;;;;;;;;;;;;;
;;;;;;;;;;;;;;;;;;;;;;;;# #ZZZ#                       #WWW# #;;;;;;;;;;;;;;;;;;;;;;;;
;;;;;;;;;;;;;;;;;;;;;;;;# #ZZZ# #######       ####### #WWW# #;;;;;;;;;;;;;;;;;;;;;;;;
;;;;;;;;;;;;;;;;;;;;;;;;# ##### #;;;;;#       #;;;;;# ##### #;;;;;;;;;;;;;;;;;;;;;;;;
;;;;;;;;;;;;;;;;;;;;;;;##       ##;;;##       ##;;;##       ##;;;;;;;;;;;;;;;;;;;;;;;
;;;;;;;;;;;;;;;;;;;;;;;###########;;;##### #####;;;###########;;;;;;;;;;;;;;;;;;;;;;;
;;;;;;;;;;;;;;;;;;;;;;;###;;;;;###;;;###;# #;###;;;###;;;;;###;;;;;;;;;;;;;;;;;;;;;;;
;;;;;;;;;;;;;;;;;;;;;;;;;;;;;;;;;;;;;;;;;# #;;;;;;;;;;;;;;;;;;;;;;;;;;;;;;;;;;;;;;;;;
;;;;;;;;;;;;;;;;;;;;;;;;;;;;;;;;;;;;;;;;;# #;;;;;;;;;;;;;;;;;;;;;;;;;;;;;;;;;;;;;;;;;
;;;;;;;###;;;;;;;###;;;;;;;;;;###;;###;;;# #;;;###;;###;;;;;;;;;;###;;;;;;;###;;;;;;;
;;;;;;;#############;;;;;;;;;;###;;###;;;# #;;;###;;###;;;;;;;;;;#############;;;;;;;
;;;;;;;##         ##;;;;;;;;;;############ ############;;;;;;;;;;##         ##;;;;;;;
;;;;;;;;#  #####  #;;;;;;################# #################;;;;;;#  #####  #;;;;;;;;
;;;;;;;## ##GGG## ##################             ################## ##fff## ##;;;;;;;
;###;;### #GGGGG# ##################             ################## #fffff# ###;;###;
########  ##GGG##        #########                 #########        ##fff##  ########
##         #####            ######                 ######            #####         ##
##  ###                       ##          #          ##                       ###  ##
;# ##G##                      ##          ##         ##                      ##f## #;
;# #GGG#                      ##        #   #        ##                      #fff# #;
;# #GGG#                      ##       #             ##                      #fff# #;
;# #GGG#  1                           ##  ^  ##                              #fff# #;
;# #GGG#                      ##             #       ##                      #fff# #;
;# #GGG#                      ##        #   #        ##                      #fff# #;
;# ##G##                      ##         ##          ##                      ##f## #;
##  ###                       ##          #          ##                       ###  ##
##         #####            ######                 ######            #####         ##
########  ##GGG##        #########                 #########        ##fff##  ########
;###;;### #GGGGG# ##################             ################## #fffff# ###;;###;
;;;;;;;## ##GGG## ##################             ################## ##fff## ##;;;;;;;
;;;;;;;;#  #####  #;;;;;;################# #################;;;;;;#  #####  #;;;;;;;;
;;;;;;;##         ##;;;;;;;;;;;########### ###########;;;;;;;;;;;##         ##;;;;;;;
;;;;;;;#############;;;;;;;;;;;####   ###   ###   ####;;;;;;;;;;;#############;;;;;;;
;;;;;;;###;;;;;;;###;;;;;;;;;;;##                   ##;;;;;;;;;;;###;;;;;;;###;;;;;;;
;;;;;;;;;;;;;;;;;;;;;;;;;;;;;;;##                   ##;;;;;;;;;;;;;;;;;;;;;;;;;;;;;;;
;;;;;;;;;;;;;;;;;;;;;;;;;;;;;;;##                   ##;;;;;;;;;;;;;;;;;;;;;;;;;;;;;;;
;;;;;;;;;;;;;;;;;;;;;;;;;;;;;;;##  #   #     #   #  ##;;;;;;;;;;;;;;;;;;;;;;;;;;;;;;;
;;;;;;;;;;;;;;;;;;;;;;;;;;;;;;;##                   ##;;;;;;;;;;;;;;;;;;;;;;;;;;;;;;;
;;;;;;;;;;;;;;;;;;;;;;;;;;;;;;;##                   ##;;;;;;;;;;;;;;;;;;;;;;;;;;;;;;;
;;;;;;;;;;;;;;;;;;;;;;;;;;;;;;;##  #   #     #   #  ##;;;;;;;;;;;;;;;;;;;;;;;;;;;;;;;
;;;;;;;;;;;;;;;;;;;;;;;;;;;;;;;##         @         ##;;;;;;;;;;;;;;;;;;;;;;;;;;;;;;;
;;;;;;;;;;;;;;;;;;;;;;;;;;;;;;;##                   ##;;;;;;;;;;;;;;;;;;;;;;;;;;;;;;;
;;;;;;;;;;;;;;;;;;;;;;;;;;;;;;;##      #     #      ##;;;;;;;;;;;;;;;;;;;;;;;;;;;;;;;
;;;;;;;;;;;;;;;;;;;;;;;;;;;;;;;####               ####;;;;;;;;;;;;;;;;;;;;;;;;;;;;;;;
;;;;;;;;;;;;;;;;;;;;;;;;;;;;;;;;########     ########;;;;;;;;;;;;;;;;;;;;;;;;;;;;;;;;
;;;;;;;;;;;;;;;;;;;;;;;;;;;;;;;;;;;;;;;#######;;;;;;;;;;;;;;;;;;;;;;;;;;;;;;;;;;;;;;;